--------a---
--c---------
------d-----
------------
--aaa---d---
-a------bbc-
--a---------
----d--d----
--b-----a---
-----c---c--
aa----------
a-----------
